Level 3
14 8
++++++++++++++
+............+
+............+
+......c.....+
+......++....+
+a.b.....c...+
++a+++b.++++++
++++++++++++++