Initial level
14 8
++++++++++++++
+............+
+............+
+......c.....+
+......++....+
+..b.....c.a.+
++a+++b.++++++
++++++++++++++