Level 5
14 8
++++++++++++++
+......c.....+
+............+
+......c.....+
+......++....+
+..b.....c.a.+
++a+++b.++++++
++++++++++++++