Level 6
21 21
+++++++++++++++++++++
+...................+
+...................+
+......c............+
+......++...........+
+..a.....b.c........+
++a+++b.+++++.......+
++++++++............+
+...................+
+...................+
+......d............+
+......++...........+
+...................+
+............j......+
+............+......+
+...................+
+..z...........j....+
+..+.........j.+....+
+...z........+......+
+...+.....d.........+
+++++++++++++++++++++