Level 2
14 8
++++++++++++++
+..cb........+
+..++........+
+............+
+............+
+c.........a.+
++a+++b.++++++
++++++++++++++